5 5
C G H G H
N J I J K
K G F H K
K I D K B
I F F M D
+---+---+---+---+---+
|   |       |       |
+   +   +   +   +   +
|       |       |   |
+   +---+---+---+   +
|   |           |   |
+   +   +---+   +   +
|   |       |   |   |
+   +---+---+   +---+
|                   |
+---+---+---+---+---+
