7 5
G F F L D
K G D I H
K I L D K
K G O G O
N J B K K
K G H K K
B B I J B
+---+---+---+---+---+
|                   |
+   +---+---+   +---+
|   |       |       |
+   +   +---+---+   +
|   |           |   |
+   +---+   +---+   +
|   |       |       |
+   +   +   +   +   +
|       |   |   |   |
+   +---+---+   +   +
|   |       |   |   |
+   +   +   +   +   +
|   |   |       |   |
+---+---+---+---+---+
